# Tomb raiding (by Ragdoll, tons of help and lua by evilmike)
# Can contain the ring of vitality.

{{
function callback.release_the_mummies(data, triggerable, triggerer, marker, ev)
    local x, y = marker:pos()
    local you_x, you_y = you.pos()

    if not you.see_cell(x, y) then
        return
    end

    crawl.mpr("딸깍거리는 소리가 들렸다.")

    for slave in iter.slave_iterator("stone_door", 1) do
        if (dgn.mons_at(slave.x, slave.y) ~= nil or (slave.x == you_x and slave.y == you_y)) then
            crawl.mpr("벽들이 잠시 흔들렸다.")
        else
            dgn.terrain_changed(slave.x, slave.y, "stone_wall", false, false, false)
            if (you.see_cell(slave.x, slave.y)) then
                -- This can happen, in theory (combination of LRD + apportation is needed)
                crawl.mpr("벽이 닫혀 길이 막혀버렸다!")
            else
                crawl.mpr("어디선가 쾅 하는 소리가 들려왔다.")
            end
        end
    end

    for slave in iter.slave_iterator("closet", 1) do
        dgn.terrain_changed(slave.x, slave.y, "floor", false, false, false)
    end

    crawl.mpr("주변의 벽들이 열렸다! 사악한 고대의 존재들이 느껴졌다...", "warning")
end
}}

NAME:   ragdoll_tomb_raider
DEPTH:  D:14-26, Crypt:1-4
ORIENT: float
TAGS:   no_item_gen no_monster_gen
KITEM:  $ = ring of regeneration unrand:ring_of_vitality / acquire any
KITEM:  1234 = gold / any / nothing
KITEM:  M4 = superb_item / any
SUBST:  . = .:10 ~:1
COLOUR: G = yellow
TILE:   G = dngn_sarcophagus_sealed
COLOUR: c = yellow
TILE:   c = wall_tomb
COLOUR: C = white
TILE:   C = wall_lab_stone
COLOUR: X = brown
TILE:   X = dngn_stone_wall_brown
FTILE:  .!~>cCXG1234M$ = floor_sandstone
: if you.absdepth() <= 17 then
KMONS: 1 = mummy / guardian mummy / nothing
KMONS: 2 = mummy / guardian mummy / nothing
KMONS: 3 = mummy / guardian mummy / mummy priest
KMONS: 4 = mummy priest
SUBST: H = .
: else
KMONS: 1 = mummy / guardian mummy
KMONS: 2 = guardian mummy / mummy priest / nothing
KMONS: 3 = guardian mummy / mummy priest / greater mummy
KMONS: 4 = mummy priest / greater mummy
KMONS: H = sphinx / nothing
: end
: if you.branch() == "Crypt" then
KMONS: M = Khufu, greater mummy
: elseif you.absdepth() <= 17 then
KMONS: M = Menkaure, mummy priest
: else
KMONS: M = mummy priest
: end
{{
    local tm = TriggerableFunction:new{func="callback.release_the_mummies",
               data={trig=false} }
    tm:add_triggerer(DgnTriggerer:new{type="item_moved", target="auto"})
    tm:add_triggerer(DgnTriggerer:new{type="item_pickup", target="auto"})
    tm:add_triggerer(DgnTriggerer:new{type="player_move"})
    lua_marker('$', tm)
    lua_marker('!', props_marker {stone_door=1})
    lua_marker('X', props_marker {closet=1})
    lua_marker('G', portal_desc {
        veto_fragmentation="veto", veto_disintegrate="veto", veto_shatter="veto" })
    set_feature_name("granite_statue", "봉인된 석관")
}}
SUBST:  ! = .
SUBST:  XC = c
MAP
xxxxxxxxxxxxxxxxxxxxx
xcccccccccccccccccccx
xc1cccGcccMcccGccc1cx
xcXc.....cXc.....cXcx
xcc...c...X...c...ccx
xccc.ccc.....ccc.cccx
xcc...ccc...ccc...ccx
xcGc...cc...cc...cGcx
xccc....cC.Cc....cccx
xc2Xc...c.$.c...cX2cx
xccccc.ccC.Ccc.cccccx
xc2Xc...ccGcc...cX2cx
xccc.....ccc.....cccx
xccG..C.......C..Gccx
xccc.....cXc.....cccx
xccXc...cc4cc...cXccx
xc3ccc...ccc...ccc3cx
xccccGc...c...cGcc>cx
xccccccc.....cccccccx
xccHHHcccC!CcccHHHccx
xc,,,,,cc,,,cc,,,,,cx
x,,,,,,,,,@,,,,,,,,,x
ENDMAP
